TAGS HTML:
MARK: TAGS REFERENTE A MARCAÇÃO DE TEXTO
B/STRONG: NEGRITO
I/EM: ITALICO/ENFASE
SMALL: TEXTO PEQUENO
DEL: TEXTO EXCLUIDO
INS: TEXTO INSERIDO OU SUBLINHADO
LINK.FAVICON: ICON
SUP: ELEVAR TEXTO
SUB: REBAIXAR TEXTO
PRE: ENDENTAÇÃO
CODE: PADRONIZAÇÃO FORMATO DE TEXTO
Q: CITAÇÃO ""
ABBR: ABREVIAÇÃO
BLOCKQUOTE: REFERÊNCIA DE LINK
OL-LI: ORDENAÇÃO DE LISTA
UL-LI: LISTA NÃO ORDENADA
DL-DT-DD: LISTA DICIONARIA (DT=TERMO- DD=DESCRIÇÃO)
A href: ANCORA UTILIZADA PARA DIRECIONAR URL DE LINKS(TARGET: _blank=abrir em nova aba REL= orige do link informado) 
PICTURE(SOURCE MEDIA/TYPE): PADRONIZAR IMAGENS OBS ORDEM CRESCENTE
SPAN: CLASSE EM <P>
HEADER: CABEÇALHO
MAIN: CONTEUDO
FOOTER: RODAPE


TAGS CSS:
BACKGROUND-COLOR: COR DE FUNDO
FONT-FAMILY: ESTILO DE FONTE
FONT-SIZE: TAMANHO DE FONTE
COLOR: COR DE FONTE
TEXT-ALIGN(JUSTIFY): ALINHAMENTO DE TEXTO
FONT: FONT-SYLE->FONT-WEGHT->FONT-SIZE->FONT-FAMILY
HOVER: INTERAÇÃO
#: ID
.: CLASS
: :PSEUDOCLASS
:: :PSEUDOSELEMENT
> : FILHO